# Extracted Words from Dictionary (Improved)

Generated: 2025-10-23T02:02:37.031Z

## Summary

- **adjectives**: 68 unique words
- **adverbs**: 46 unique words
- **alphabet**: 26 unique words
- **articles**: 9 unique words
- **conjunctions**: 7 unique words
- **expressions**: 3 unique words
- **interjections**: 0 unique words
- **interrogatives**: 6 unique words
- **nouns**: 0 unique words
- **prepositions**: 15 unique words
- **pronouns**: 40 unique words
- **propernouns**: 0 unique words
- **verbs**: 176 unique words

## ADJECTIVES (68 unique words)

argenté | autre | autres | beige | belle | bon
bons | chaque | clair | contente | contents | culturelles
dernier | difficile | différente | doré | délicieux | entier
européennes | excellent | excellente | fatigué | foncé | francophone
français | française | génial | historique | historiques | internationales
jaune | lointain(e) | magnifique | marron | meilleur | meilleures
moderne | mondiales | multicolore | même | nouveau | nouveaux
nouvelle | orange | parfait | pire | politiques | populaire
proche | public | pâle | quelques | quotidienne | rapide
rapides | reconnaissante | rose | rouge | significatif | super
top | tous | tout | toute | toutes | typique
économiques | éducatif

## ADVERBS (46 unique words)

ainsi | alors | aussi | bah | beaucoup | bien
complètement | dehors | demain | déjà | encore | enfin
ensemble | ensuite | facilement | finalement | hier | hyper
ici | jamais | lentement | là | maintenant | mal
merci | mieux | moins | non | oui | parfois
partout | plus | probablement | puis | rapidement | régulièrement
simplement | soudain | sérieusement | toujours | trop | très
vachement | voici | voilà | vraiment

## ALPHABET (26 unique words)

a | b | c | d | e | f
g | h | i | j | k | l
m | n | o | p | q | r
s | t | u | v | w | x
y | z

## ARTICLES (9 unique words)

au | aux | des | du | la | le
les | un | une

## CONJUNCTIONS (7 unique words)

car | comme | donc | et | mais | ou
puisque

## EXPRESSIONS (3 unique words)

bonjour | pardon | salut

## INTERROGATIVES (6 unique words)

combien | comment | où | pourquoi | quand | qui

## PREPOSITIONS (15 unique words)

après | avant | avec | dans | de | depuis
derrière | devant | entre | parmi | pendant | pour
sous | sur | à

## PRONOUNS (40 unique words)

ce | ceci | cela | certains | ces | cet
cette | elle | elles | eux | il | ils
je | leur | leurs | lui | ma | me
mes | mon | nos | notre | nous | on
quoi | sa | se | ses | soi | son
ta | te | tes | toi | ton | tu
vos | votre | vous | ça

## VERBS (176 unique words)

Aie! | Allez! | Ayez! | Fais! | Faites! | Mange!
Mangez! | Parle! | Parlez! | Pars! | Pense! | Prends!
Prenez! | Regarde! | Regardez! | Sois! | Soyez! | Va!
Venez! | Viens! | achèterais | activement | admirer | adorent
aider | aies | aimer | ait | aller | allez
appeler | apprend | apprendre | arriver | attendre | avoir
beaucoup | bien | boire | brillaient | briller | change
cherche | chercher | combine | commander | communiquent | comprend
comprendre | comprends | comprenez | connais | connaître | connectent
continue | continuer | continuez | courir | croire | croit
créent | demain | demander | devenir | deviennent | devoir
dire | discutent | dois | donner | dormir | découvrir
déjà | dépend | embrassant | encourage | enrichissent | enseigner
essaie | essaies | essayé | existe | exportent | faire
fais | faites | finir | fonctionne | grimper | hier
influence | inspirent | internationalement | irrégulier | jouer | maintenant
mal | manger | marcher | mettre | montrent | nager
ne...pas | parler | participe | partir | payer | pense
pensent | penser | perdu | permet | peuvent | pleuvoir
pousser | pouvoir | prendre | profiter | protéger | préfèrent
préserve | puisse | puissions | reconnu | recycler | regarder
rencontrer | rendre | renoncerais | rentre | rester | retrouvé
réussi | réussisse | réussissions | révise | réviser | sache
saches | sais | sait | sauter | savoir | serais
soient | sois | soit | sortir | souffler | soyons
tomber | tourne | tournez | travailler | trouve | trouver
utiliser | va | venir | vienne | viens | vivre
voient | voir | voler | vouloir | voyagerais | Écoute!
Écoutez! | économiser | écouter | épeler | étudie | étudier
évoluer | être

## ALL WORDS (Alphabetical)

Total unique words across all categories: 389

Aie! | Allez! | Ayez! | Fais! | Faites! | Mange! | Mangez! | Parle!
Parlez! | Pars! | Pense! | Prends! | Prenez! | Regarde! | Regardez! | Sois!
Soyez! | Va! | Venez! | Viens! | a | achèterais | activement | admirer
adorent | aider | aies | aimer | ainsi | ait | aller | allez
alors | appeler | apprend | apprendre | après | argenté | arriver | attendre
au | aussi | autre | autres | aux | avant | avec | avoir
b | bah | beaucoup | beige | belle | bien | boire | bon
bonjour | bons | brillaient | briller | c | car | ce | ceci
cela | certains | ces | cet | cette | change | chaque | cherche
chercher | clair | combien | combine | commander | comme | comment | communiquent
complètement | comprend | comprendre | comprends | comprenez | connais | connaître | connectent
contente | contents | continue | continuer | continuez | courir | croire | croit
créent | culturelles | d | dans | de | dehors | demain | demander
depuis | dernier | derrière | des | devant | devenir | deviennent | devoir
difficile | différente | dire | discutent | dois | donc | donner | dormir
doré | du | découvrir | déjà | délicieux | dépend | e | elle
elles | embrassant | encore | encourage | enfin | enrichissent | enseigner | ensemble
ensuite | entier | entre | essaie | essaies | essayé | et | européennes
eux | excellent | excellente | existe | exportent | f | facilement | faire
fais | faites | fatigué | finalement | finir | fonctionne | foncé | francophone
français | française | g | grimper | génial | h | hier | historique
historiques | hyper | i | ici | il | ils | influence | inspirent
internationalement | internationales | irrégulier | j | jamais | jaune | je | jouer
k | l | la | le | lentement | les | leur | leurs
lointain(e) | lui | là | m | ma | magnifique | maintenant | mais
mal | manger | marcher | marron | me | meilleur | meilleures | merci
mes | mettre | mieux | moderne | moins | mon | mondiales | montrent
multicolore | même | n | nager | ne...pas | non | nos | notre
nous | nouveau | nouveaux | nouvelle | o | on | orange | ou
oui | où | p | pardon | parfait | parfois | parler | parmi
participe | partir | partout | payer | pendant | pense | pensent | penser
perdu | permet | peuvent | pire | pleuvoir | plus | politiques | populaire
pour | pourquoi | pousser | pouvoir | prendre | probablement | proche | profiter
protéger | préfèrent | préserve | public | puis | puisque | puisse | puissions
pâle | q | quand | quelques | qui | quoi | quotidienne | r
rapide | rapidement | rapides | reconnaissante | reconnu | recycler | regarder | rencontrer
rendre | renoncerais | rentre | rester | retrouvé | rose | rouge | régulièrement
réussi | réussisse | réussissions | révise | réviser | s | sa | sache
saches | sais | sait | salut | sauter | savoir | se | serais
ses | significatif | simplement | soi | soient | sois | soit | son
sortir | soudain | souffler | sous | soyons | super | sur | sérieusement
t | ta | te | tes | toi | tomber | ton | top
toujours | tourne | tournez | tous | tout | toute | toutes | travailler
trop | trouve | trouver | très | tu | typique | u | un
une | utiliser | v | va | vachement | venir | vienne | viens
vivre | voici | voient | voilà | voir | voler | vos | votre
vouloir | vous | voyagerais | vraiment | w | x | y | z
Écoute! | Écoutez! | à | ça | économiques | économiser | écouter | éducatif
épeler | étudie | étudier | évoluer | être
