# Extracted Words from Dictionary

Generated: 2025-10-23T02:02:28.961Z

## Summary

- **adjectives**: 215 words
- **adverbs**: 148 words
- **alphabet**: 26 words
- **articles**: 9 words
- **conjunctions**: 10 words
- **expressions**: 3 words
- **interjections**: 0 words
- **interrogatives**: 6 words
- **nouns**: 0 words
- **prepositions**: 15 words
- **pronouns**: 40 words
- **properNouns**: 0 words
- **verbs**: 301 words

## ADJECTIVES (215 words)

argenté | argenté | argenté | argenté | autre
autre | autre | autre | autres | beige
beige | beige | beige | belle | bon
bon | bon | bon | bons | chaque
chaque | chaque | chaque | clair | clair
clair | clair | contente | contents | culturelles
culturelles | culturelles | culturelles | dernier | dernier
dernier | dernier | difficile | difficile | difficile
difficile | différente | différente | différente | différente
doré | doré | doré | doré | délicieux
délicieux | délicieux | délicieux | entier | européennes
européennes | européennes | européennes | excellent | excellent
excellent | excellent | excellente | excellente | excellente
excellente | fatigué | fatigué | fatigué | fatigué
foncé | foncé | foncé | foncé | francophone
français | français | français | français | française
française | française | française | génial | génial
génial | génial | historique | historique | historique
historique | historiques | internationales | internationales | internationales
internationales | jaune | jaune | jaune | jaune
lointain(e) | magnifique | magnifique | magnifique | magnifique
marron | marron | marron | marron | meilleur
meilleur | meilleur | meilleur | meilleures | meilleures
meilleures | meilleures | moderne | moderne | moderne
moderne | mondiales | mondiales | mondiales | mondiales
multicolore | multicolore | multicolore | multicolore | même
même | même | même | nouveau | nouveau
nouveau | nouveau | nouveaux | nouvelle | orange
orange | orange | orange | parfait | parfait
parfait | parfait | pire | pire | pire
pire | politiques | politiques | politiques | politiques
populaire | proche | public | pâle | pâle
pâle | pâle | quelques | quotidienne | quotidienne
quotidienne | quotidienne | rapide | rapide | rapide
rapide | rapides | reconnaissante | reconnaissante | reconnaissante
reconnaissante | rose | rose | rose | rose
rouge | rouge | rouge | rouge | significatif
significatif | significatif | significatif | super | super
super | super | top | top | top
top | tous | tout | tout | tout
tout | toute | toute | toute | toute
toutes | toutes | toutes | toutes | typique
économiques | économiques | économiques | économiques | éducatif

## ADVERBS (148 words)

ainsi | ainsi | ainsi | ainsi | alors
alors | alors | alors | aussi | aussi
aussi | aussi | bah | bah | beaucoup
bien | complètement | complètement | complètement | complètement
dehors | dehors | dehors | dehors | demain
déjà | encore | encore | encore | encore
enfin | enfin | enfin | enfin | ensemble
ensemble | ensemble | ensemble | ensuite | ensuite
ensuite | ensuite | facilement | facilement | facilement
facilement | finalement | finalement | finalement | finalement
hier | hyper | hyper | hyper | hyper
ici | ici | ici | ici | jamais
jamais | jamais | jamais | lentement | lentement
lentement | lentement | là | là | là
là | maintenant | mal | merci | merci
mieux | mieux | mieux | mieux | moins
moins | moins | moins | non | non
oui | oui | parfois | parfois | parfois
parfois | partout | partout | partout | partout
plus | plus | plus | plus | probablement
probablement | probablement | probablement | puis | puis
puis | puis | rapidement | rapidement | rapidement
rapidement | régulièrement | régulièrement | régulièrement | régulièrement
simplement | simplement | simplement | simplement | soudain
soudain | soudain | soudain | sérieusement | sérieusement
sérieusement | sérieusement | toujours | toujours | toujours
toujours | trop | trop | trop | trop
très | vachement | vachement | vachement | vachement
voici | voici | voilà | voilà | vraiment
vraiment | vraiment | vraiment

## ALPHABET (26 words)

a | b | c | d | e
f | g | h | i | j
k | l | m | n | o
p | q | r | s | t
u | v | w | x | y
z

## ARTICLES (9 words)

au | aux | des | du | la
le | les | un | une

## CONJUNCTIONS (10 words)

car | comme | donc | et | mais
ou | puisque | puisque | puisque | puisque

## EXPRESSIONS (3 words)

bonjour | pardon | salut

## INTERROGATIVES (6 words)

combien | comment | où | pourquoi | quand
qui

## PREPOSITIONS (15 words)

après | avant | avec | dans | de
depuis | derrière | devant | entre | parmi
pendant | pour | sous | sur | à

## PRONOUNS (40 words)

ce | ceci | cela | certains | ces
cet | cette | elle | elles | eux
il | ils | je | leur | leurs
lui | ma | me | mes | mon
nos | notre | nous | on | quoi
sa | se | ses | soi | son
ta | te | tes | toi | ton
tu | vos | votre | vous | ça

## VERBS (301 words)

Aie! | Aie! | Allez! | Allez! | Ayez!
Ayez! | Fais! | Fais! | Faites! | Faites!
Mange! | Mange! | Mangez! | Mangez! | Parle!
Parle! | Parlez! | Parlez! | Pars! | Pars!
Pense! | Pense! | Prends! | Prends! | Prenez!
Prenez! | Regarde! | Regarde! | Regardez! | Regardez!
Sois! | Sois! | Soyez! | Soyez! | Va!
Va! | Venez! | Venez! | Viens! | Viens!
achèterais | achèterais | activement | admirer | adorent
adorent | aider | aider | aies | aies
aimer | ait | ait | aller | aller
allez | allez | appeler | appeler | apprend
apprend | apprendre | apprendre | arriver | attendre
avoir | avoir | avoir | avoir | beaucoup
bien | boire | boire | brillaient | brillaient
briller | change | change | cherche | cherche
chercher | combine | combine | commander | communiquent
communiquent | comprend | comprend | comprendre | comprends
comprends | comprenez | comprenez | connais | connais
connaître | connectent | connectent | continue | continue
continuer | continuer | continuez | continuez | courir
croire | croit | croit | créent | créent
demain | demander | devenir | devenir | deviennent
deviennent | devoir | devoir | dire | discutent
discutent | dois | dois | donner | donner
dormir | découvrir | déjà | dépend | dépend
embrassant | embrassant | encourage | encourage | enrichissent
enrichissent | enseigner | essaie | essaie | essaies
essaies | essayé | essayé | existe | existe
exportent | exportent | faire | faire | fais
fais | faites | faites | finir | fonctionne
fonctionne | grimper | hier | influence | inspirent
inspirent | internationalement | irrégulier | jouer | jouer
maintenant | mal | manger | marcher | mettre
montrent | montrent | nager | ne...pas | parler
participe | participe | partir | partir | payer
pense | pense | pensent | pensent | penser
perdu | perdu | permet | permet | peuvent
peuvent | pleuvoir | pleuvoir | pousser | pouvoir
pouvoir | prendre | profiter | profiter | protéger
protéger | préfèrent | préfèrent | préserve | préserve
puisse | puisse | puissions | puissions | reconnu
reconnu | recycler | recycler | regarder | rencontrer
rencontrer | rendre | rendre | renoncerais | renoncerais
rentre | rester | retrouvé | retrouvé | réussi
réussi | réussisse | réussisse | réussissions | réussissions
révise | révise | réviser | sache | sache
saches | saches | sais | sais | sait
sait | sauter | savoir | savoir | serais
serais | soient | soient | sois | sois
soit | soit | sortir | sortir | souffler
soyons | soyons | tomber | tourne | tourne
tournez | tournez | travailler | trouve | trouve
trouver | utiliser | utiliser | va | va
venir | venir | vienne | vienne | viens
viens | vivre | voient | voient | voir
voir | voler | vouloir | vouloir | voyagerais
voyagerais | Écoute! | Écoute! | Écoutez! | Écoutez!
économiser | économiser | écouter | épeler | étudie
étudie | étudier | évoluer | évoluer | être
être

